 ********************
*    *     *   *    *
* *  ***   * * **** *
*k*        * *      *
********** * * ******
********   * *      *
********** * ****** *
*            *G     *
*********************
