 *******
*       *
* *     *
*k*     *
 *******
